2222222222
2444400002
2000000002
2000033002
2000000002
2330000002
2000000002
2000000002
2000000002
2000001002
2222222222