2222222222
2443030002
2440000002
2330000002
2000000002
2000000002
2000000002
2000000002
2000000002
2000001002
2222222222